{ "list": [
{ "name": "01", "arr": [
	[ 0, 0, 0, 0, 0, 0, 0, 0, 0, 0, 0, 2, 2, 2, 2, 2, 2, 2, 0, 0, 0, 0, 0, 0, 0 ],
	[ 2, 2, 2, 2, 2, 2, 2, 2, 0, 0, 0, 2, 1, 1, 1, 1, 1, 2, 2, 2, 2, 2, 2, 2, 0 ],
	[ 2, 700, 2, 1, 1, 1, 1, 2, 2, 2, 2, 2, 1, 1, 1, 1, 1, 1, 1, 1, 2, 1, 1, 2, 0 ],
	[ 2, 600, 600, 600, 600, 600, 600, 600, 600, 600, 600, 600, 600, 600, 600, 600, 600, 600, 600, 600, 600, 600, 600, 2, 0 ],
	[ 2, 1, 2, 1, 1, 1, 1, 2, 2, 2, 2, 2, 600, 2, 2, 2, 2, 2, 2, 1, 2, 1, 700, 2, 0 ],
	[ 2, 2, 2, 2, 2, 2, 2, 2, 0, 0, 0, 2, 600, 2, 0, 0, 0, 0, 2, 2, 2, 2, 2, 2, 0 ],
	[ 0, 0, 0, 0, 0, 0, 0, 0, 0, 0, 0, 2, 600, 2, 0, 0, 0, 0, 0, 0, 0, 0, 0, 0, 0 ],
	[ 0, 0, 0, 2, 2, 2, 2, 2, 2, 2, 2, 2, 600, 2, 2, 2, 2, 2, 2, 2, 2, 2, 2, 0, 0 ],
	[ 0, 0, 0, 2, 1, 1, 1, 1, 1, 2, 1, 600, 600, 600, 1, 1, 2, 1, 1, 1, 1, 1, 2, 0, 0 ],
	[ 0, 0, 0, 2, 1, 1, 1, 1, 40, 30, 600, 600, 1, 600, 600, 600, 30, 40, 1, 1, 1, 1, 2, 0, 0 ],
	[ 0, 0, 0, 2, 1, 1, 1, 1, 1, 2, 1, 1, 1, 600, 1, 1, 2, 1, 1, 1, 1, 1, 2, 0, 0 ],
	[ 0, 0, 0, 2, 1, 1, 1, 1, 1, 2, 1, 1, 1, 800, 1, 1, 2, 1, 1, 1, 1, 1, 2, 0, 0 ],
	[ 0, 0, 0, 2, 2, 2, 2, 2, 2, 2, 2, 2, 2, 2, 2, 2, 2, 2, 2, 2, 2, 2, 2, 0, 0 ],
	[ 0, 0, 0, 0, 0, 0, 0, 0, 0, 0, 0, 0, 0, 0, 0, 0, 0, 0, 0, 0, 0, 0, 0, 0, 0 ]
]}]}