{ "list": [
{ "name": "01", "arr": [
	[ 0, 0, 0, 0, 0, 0, 0, 0, 0, 0, 0, 2, 2, 2, 2, 2, 2, 2, 0, 0, 0, 0, 0, 0, 0 ],
	[ 0, 0, 2, 2, 2, 2, 2, 2, 0, 0, 0, 2, 1, 1, 1, 1, 1, 2, 2, 2, 2, 2, 2, 2, 0 ],
	[ 0, 0, 2, 1, 1, 1, 1, 2, 2, 2, 2, 2, 1, 1, 1, 1, 1, 1, 1, 1, 1, 1, 1, 2, 0 ],
	[ 0, 0, 2, 1, 1, 1, 1, 1, 1, 1, 1, 1, 1, 1, 1, 1, 1, 1, 1, 1, 1, 1, 1, 2, 0 ],
	[ 0, 0, 2, 1, 1, 1, 1, 2, 2, 2, 2, 2, 1, 2, 2, 2, 2, 2, 2, 2, 2, 1, 1, 2, 0 ],
	[ 0, 0, 2, 2, 2, 2, 2, 2, 0, 0, 0, 2, 1, 2, 0, 0, 0, 0, 0, 0, 2, 2, 2, 2, 0 ],
	[ 0, 0, 0, 0, 0, 0, 0, 0, 0, 0, 0, 2, 1, 2, 0, 0, 0, 0, 0, 0, 0, 0, 0, 0, 0 ],
	[ 0, 0, 0, 2, 2, 2, 2, 2, 2, 2, 2, 2, 1, 2, 2, 2, 2, 2, 2, 2, 2, 2, 2, 0, 0 ],
	[ 0, 0, 0, 2, 1, 1, 1, 1, 1, 2, 1, 1, 1, 1, 1, 1, 2, 1, 1, 1, 1, 1, 2, 0, 0 ],
	[ 0, 0, 0, 2, 1, 1, 1, 1, 40, 30, 1, 1, 1, 1, 1, 1, 30, 40, 1, 1, 1, 1, 2, 0, 0 ],
	[ 0, 0, 0, 2, 1, 1, 1, 1, 1, 2, 1, 1, 1, 1, 1, 1, 2, 1, 1, 1, 1, 1, 2, 0, 0 ],
	[ 0, 0, 0, 2, 1, 1, 1, 1, 1, 2, 1, 1, 1, 1, 1, 1, 2, 1, 1, 1, 1, 1, 2, 0, 0 ],
	[ 0, 0, 0, 2, 2, 2, 2, 2, 2, 2, 2, 2, 2, 2, 2, 2, 2, 2, 2, 2, 2, 2, 2, 0, 0 ],
	[ 0, 0, 0, 0, 0, 0, 0, 0, 0, 0, 0, 0, 0, 0, 0, 0, 0, 0, 0, 0, 0, 0, 0, 0, 0 ]
]}]}