{ "list": [
{ "name": "01", "arr": [
	[ 2, 2, 2, 2, 2, 2, 2, 2, 2, 0, 2, 2, 2, 2 ],
	[ 2, 1, 1, 1, 1, 1, 1, 1, 2, 0, 2, 1, 1, 2 ],
	[ 2, 1, 1, 1, 1, 1, 1, 1, 2, 0, 2, 1, 1, 2 ],
	[ 2, 1, 1, 1, 1, 1, 1, 1, 2, 0, 2, 1, 1, 2 ],
	[ 2, 1, 1, 1, 1, 1, 1, 1, 2, 0, 2, 1, 1, 2 ],
	[ 2, 1, 1, 1, 1, 1, 1, 1, 2, 0, 2, 1, 1, 2 ],
	[ 2, 2, 2, 2, 2, 1, 2, 2, 2, 0, 2, 1, 1, 2 ],
	[ 0, 0, 0, 0, 2, 1, 2, 0, 0, 0, 2, 1, 1, 2 ],
	[ 0, 0, 0, 0, 2, 1, 2, 0, 2, 2, 2, 1, 1, 2 ],
	[ 0, 0, 0, 0, 2, 1, 2, 0, 2, 1, 1, 1, 1, 2 ],
	[ 0, 0, 0, 0, 2, 1, 2, 0, 2, 1, 2, 1, 1, 2 ],
	[ 2, 2, 2, 0, 2, 1, 2, 0, 2, 1, 2, 2, 2, 2 ],
	[ 2, 1, 2, 0, 2, 1, 2, 0, 2, 1, 2, 0, 0, 0 ],
	[ 2, 1, 2, 0, 2, 1, 2, 2, 2, 1, 2, 0, 0, 0 ],
	[ 2, 1, 2, 0, 2, 1, 1, 1, 1, 1, 2, 2, 0, 0 ],
	[ 2, 1, 2, 2, 2, 1, 2, 2, 2, 1, 1, 2, 0, 0 ],
	[ 2, 1, 1, 1, 1, 1, 2, 1, 2, 1, 1, 2, 0, 0 ],
	[ 2, 2, 2, 2, 2, 1, 2, 1, 2, 1, 1, 2, 0, 0 ],
	[ 2, 1, 1, 1, 2, 1, 30, 1, 2, 1, 1, 2, 0, 0 ],
	[ 2, 1, 1, 1, 30, 1, 2, 1, 2, 1, 1, 2, 2, 0 ],
	[ 2, 1, 1, 1, 2, 1, 2, 1, 2, 1, 1, 1, 2, 0 ],
	[ 2, 1, 1, 2, 2, 2, 2, 2, 2, 2, 30, 2, 2, 0 ],
	[ 2, 1, 1, 2, 1, 1, 1, 1, 1, 1, 1, 1, 2, 0 ],
	[ 2, 1, 1, 2, 1, 1, 1, 1, 1, 1, 1, 1, 2, 0 ],
	[ 2, 2, 2, 2, 2, 2, 2, 2, 2, 2, 2, 2, 2, 0 ]
]},
{ "name": "02", "arr": [
	[ 2, 2, 2, 2, 2, 2, 2, 2, 2, 2, 2, 2, 2, 2, 2, 2, 2, 2, 2, 2, 2, 2, 2, 2, 2, 2, 2, 2, 2, 2, 2, 2, 2, 2, 2, 2, 2, 2, 2, 2, 2, 2, 2, 2, 2 ],
	[ 2, 1, 1, 1, 1, 1, 1, 1, 1, 1, 1, 1, 1, 2, 1, 1, 1, 1, 1, 1, 1, 1, 1, 1, 1, 1, 1, 1, 1, 1, 1, 2, 1, 1, 1, 1, 1, 1, 1, 1, 1, 1, 1, 1, 2 ],
	[ 2, 1, 1, 1, 1, 1, 1, 1, 1, 1, 1, 1, 1, 2, 1, 1, 1, 1, 1, 1, 1, 1, 1, 1, 1, 1, 1, 1, 1, 1, 1, 2, 1, 1, 1, 1, 1, 2, 1, 1, 1, 1, 1, 1, 2 ],
	[ 2, 1, 1, 1, 1, 1, 1, 1, 1, 1, 1, 1, 1, 2, 1, 1, 1, 1, 1, 1, 1, 1, 1, 1, 1, 1, 1, 1, 1, 1, 1, 1, 1, 1, 1, 1, 1, 2, 1, 1, 1, 1, 1, 1, 2 ],
	[ 2, 1, 1, 1, 1, 1, 1, 1, 1, 1, 1, 1, 1, 2, 1, 1, 1, 1, 1, 1, 1, 1, 1, 1, 1, 1, 1, 1, 1, 1, 1, 2, 1, 2, 2, 2, 1, 2, 1, 1, 1, 1, 1, 1, 2 ],
	[ 2, 1, 1, 1, 1, 1, 1, 1, 1, 1, 1, 1, 1, 2, 1, 1, 1, 2, 2, 2, 2, 2, 2, 2, 2, 2, 2, 2, 2, 2, 2, 2, 1, 2, 1, 2, 1, 2, 1, 1, 1, 1, 1, 1, 2 ],
	[ 2, 1, 2, 2, 2, 2, 2, 2, 2, 2, 2, 2, 2, 2, 1, 1, 1, 2, 1, 1, 1, 1, 1, 2, 1, 1, 1, 1, 1, 1, 1, 2, 1, 2, 1, 2, 1, 2, 1, 1, 1, 1, 1, 1, 2 ],
	[ 2, 1, 1, 1, 1, 1, 2, 1, 1, 1, 1, 1, 1, 2, 1, 1, 1, 2, 1, 1, 1, 1, 1, 2, 1, 1, 1, 1, 1, 1, 1, 1, 1, 2, 1, 2, 1, 2, 1, 1, 1, 1, 1, 1, 2 ],
	[ 2, 1, 1, 1, 1, 1, 2, 1, 1, 1, 2, 1, 1, 2, 2, 2, 2, 2, 1, 1, 1, 1, 1, 2, 1, 1, 1, 1, 1, 1, 1, 2, 1, 2, 1, 2, 1, 2, 2, 2, 2, 1, 2, 2, 2 ],
	[ 2, 1, 1, 1, 1, 1, 2, 1, 1, 1, 2, 1, 1, 1, 1, 1, 1, 1, 1, 1, 1, 1, 1, 2, 1, 1, 1, 1, 1, 1, 1, 2, 1, 2, 1, 2, 1, 2, 1, 1, 2, 1, 1, 1, 2 ],
	[ 2, 1, 1, 1, 1, 1, 2, 1, 1, 1, 2, 1, 1, 2, 2, 2, 2, 2, 1, 1, 1, 1, 1, 2, 1, 1, 1, 1, 1, 1, 1, 2, 1, 2, 2, 2, 1, 2, 1, 1, 2, 1, 1, 1, 2 ],
	[ 2, 1, 1, 1, 1, 1, 2, 1, 1, 1, 2, 1, 1, 2, 1, 1, 1, 2, 1, 1, 1, 1, 1, 1, 1, 1, 1, 1, 1, 1, 1, 2, 1, 1, 1, 1, 1, 2, 1, 1, 2, 1, 1, 1, 2 ],
	[ 2, 1, 1, 1, 1, 1, 2, 2, 1, 2, 2, 2, 2, 2, 1, 1, 1, 2, 2, 2, 2, 2, 2, 2, 2, 2, 2, 2, 2, 2, 2, 2, 2, 2, 2, 2, 2, 2, 1, 1, 2, 1, 1, 1, 2 ],
	[ 2, 1, 1, 1, 1, 1, 2, 1, 1, 1, 1, 1, 1, 2, 1, 1, 1, 1, 1, 1, 1, 1, 1, 1, 2, 1, 1, 1, 1, 1, 1, 1, 1, 1, 1, 1, 1, 2, 1, 1, 2, 2, 1, 2, 2 ],
	[ 2, 1, 1, 1, 1, 1, 2, 1, 1, 1, 1, 1, 1, 2, 1, 1, 1, 1, 1, 1, 2, 1, 1, 1, 2, 1, 1, 1, 1, 1, 1, 1, 1, 1, 1, 1, 1, 2, 1, 1, 2, 1, 1, 1, 2 ],
	[ 2, 1, 1, 1, 1, 1, 2, 1, 1, 1, 1, 1, 1, 2, 2, 2, 2, 2, 2, 2, 2, 2, 2, 1, 2, 1, 1, 1, 1, 1, 1, 1, 1, 1, 1, 1, 1, 2, 1, 1, 2, 1, 1, 1, 2 ],
	[ 2, 1, 1, 1, 1, 1, 2, 2, 2, 2, 2, 2, 2, 2, 1, 1, 2, 1, 1, 1, 1, 1, 1, 1, 2, 1, 1, 1, 1, 1, 1, 1, 1, 1, 1, 1, 1, 2, 1, 1, 2, 1, 1, 1, 2 ],
	[ 2, 1, 1, 1, 1, 1, 1, 1, 1, 1, 1, 1, 1, 1, 1, 1, 2, 1, 1, 1, 1, 1, 1, 1, 2, 2, 2, 2, 2, 2, 2, 2, 2, 2, 2, 2, 1, 2, 1, 1, 1, 1, 1, 1, 2 ],
	[ 2, 1, 1, 1, 1, 1, 1, 1, 1, 1, 1, 1, 1, 1, 1, 1, 1, 1, 1, 1, 1, 1, 1, 1, 1, 1, 1, 1, 1, 1, 1, 1, 1, 1, 1, 1, 1, 1, 1, 1, 2, 1, 1, 1, 2 ],
	[ 2, 2, 2, 2, 2, 2, 2, 2, 2, 2, 2, 2, 2, 2, 2, 2, 2, 2, 2, 2, 2, 2, 2, 2, 2, 2, 2, 2, 2, 2, 2, 2, 2, 2, 2, 2, 2, 2, 2, 2, 2, 2, 2, 2, 2 ]
]}]}